=HomeServlet
login=LoginServlet
login-page=login.jsp
create-account=CreateAccountServlet
create-account-page=create-account.jsp
active-required-page=active-required.html
sendActivationCode=SendActivationCodeServlet
active-account-page=active-account.jsp
active-acount=ActiveAccountServlet
invalid=invalid.html
logout=LogoutServlet
home=HomeServlet
homePage=home.jsp
search-car=SearchCarServlet
choose-category=LoadCarByCategoryServlet
view-detail=ViewCarDetailServlet
detailPage=car-detail.jsp
rental-car=RentalCarServlet
view-cart-page=cart.jsp
view-cart=ViewCartServlet
view-order-history=ViewOrderHistoryServlet
delete-item=DeleteItemServlet
update-item-quantity=UpdateItemServlet
calculate-total-payment=CalculateTotalServlet
confirm-cart=ConfirmCartServlet
confirm-success-page=checkoutSuccess.html
track-rental-order=TrackRentalOrderServlet
track-rental-page=trackRental.jsp
search-order=SearchOrderServlet
delete-order=DeleteOrderServlet
send-feedback=SendFeedbackServlet